{
"tiles":[
    [0,0,0,0,0,0,0,0,0,0,0,0,0,0,0,0],
    [0,0,0,0,0,0,0,0,0,0,0,0,0,0,0,0],
    [0,0,0,0,0,3,3,0,3,3,3,0,0,0,0,0],
    [0,0,0,0,0,3,3,2,3,3,3,3,3,0,0,0],
    [0,0,0,0,3,3,3,0,0,2,0,3,3,0,0,0],
    [0,0,0,0,3,2,3,0,3,3,0,3,0,0,0,0],
    [0,0,0,0,0,0,2,0,3,3,0,3,0,0,0,0],
    [0,0,0,0,0,0,3,2,3,3,3,3,0,0,0,0],
    [0,0,0,0,0,0,2,0,3,0,3,3,0,0,0,0],
    [0,0,0,0,0,0,3,3,3,0,0,0,0,0,0,0],
    [0,0,0,0,0,0,0,0,0,0,0,0,0,0,0,0],
    [0,0,0,0,0,0,0,0,0,0,0,0,0,0,0,0],
    [0,0,0,0,0,0,0,0,0,0,0,0,0,0,0,0]
],
"goals":[
    {"c": 8, "r": 5, "color": 0},
    {"c": 8, "r": 6, "color": 0},
    {"c": 8, "r": 7, "color": 0},
    {"c": 9, "r": 5, "color": 0},
    {"c": 9, "r": 6, "color": 0},
    {"c": 9, "r": 7, "color": 0}
],
"player": {"c":6, "r":7}
}
