{
"tiles":[
    [0,0,0,0,0,0,0,0,0,0,0,0,0,0,0,0],
    [0,0,0,0,0,0,0,0,0,0,0,0,0,0,0,0],
    [0,0,0,3,3,3,3,3,7,1,1,1,1,0,0,0],
    [0,0,3,3,3,3,3,3,3,1,1,1,1,1,0,0],
    [0,0,3,3,3,0,2,3,1,1,0,0,4,3,0,0],
    [0,0,3,0,3,3,0,3,1,0,1,1,1,1,0,0],
    [0,0,3,0,3,3,0,3,1,0,1,1,1,1,0,0],
    [0,0,3,3,0,3,3,1,1,1,0,0,3,3,0,0],
    [0,0,3,3,3,3,3,3,4,1,1,1,1,1,0,0],
    [0,0,0,3,3,3,3,7,1,1,1,1,1,0,0,0],
    [0,0,0,0,0,0,0,0,0,0,0,0,0,0,0,0],
    [0,0,0,0,0,0,0,0,0,0,0,0,0,0,0,0]
],
"goals":[
    {"c": 10, "r": 5, "color": 1},
    {"c": 10, "r": 6, "color": 1},
    {"c": 11, "r": 5, "color": 1},
    {"c": 11, "r": 6, "color": 1},
    {"c": 4, "r": 5, "color": 0},
    {"c": 4, "r": 6, "color": 0},
    {"c": 5, "r": 5, "color": 0},
    {"c": 5, "r": 6, "color": 0}
],
"player": {"c":2, "r":5}
}
